PPPPPPPPPPPPPPPPPPPP
SP................PS
SP................PS
SP.....S....S.....PS
SP.....S....S.....PS
SP.....S....S.....PS
SP.....S....S.....PS
SP.....S....S.....PS
SP.....S....S.....PS
SO.....S....S......L
PPPPPPPPPPPPPPPPPPPP
SSSSSSSSSSSSSSSSSSSS
