PPPPPPPPPPSSSSSSSSSS
S...................
S..................L
SO.................S
SP.................S
SP........P........S
SP........PS.......S
SP........PSS......S
SP..PPPPP.PSSS.....S
SP...S.S..PSSSS..P.S
SSXXXSXSXXSPPPPPPPPS
SSSSSSSSSSSSSSSSSSSS