SSSSSSSSSSSSSSSSSSSS
S.......P...........
S.......P...........
S.......P...........
S.......P...........
S.......P...........
SO......P...........
PPP.....P..........L
P.......P.....PPPPPP
P.......P....PSSSSSS
P............PSSSSSS
PPPPPPPPPPPPPPSSSSSS