SSSSSSSSSSSSSSSSSSPS
S................S..
S...................
S...................
S...................
S...................
S...................
S..................L
SO................PS
S..P.......P......PS
S.PPXXXXXXXPP.....PS
SPPPPPPPPPPPPPSSSSSS