SSSSSSSSSSSSSSSS
S..............S
S..PSP.........S
S..PSP.........S
...PSP..........
SSSSSSSSSSSSSSSS