SSSSSSSSSSSSSSSSSSSS
SO........S........S
SS........S........S
SS........S........S
SS......PPPP.......P
SS.................P
SS......PPPP.......P
SS........S........S
SS........S...XXXXXS
SS........S........L
SSXXXXPXXXSPPPPPPPPS
SSSSSSSSSSSSSSSSSSSS