SSSSSSSSSSSSSSSSSSSS
S..................S
S..................S
SO..S..S..S..S.....S
SSSXSXXSXXSXXSXXSS.S
S..................S
S..................S
S..................S
S....S..S..S..S....S
S..SXSXXSXXSXXSXXSSS
S..................L
SPPPPPPPPPPPPPPPPPPP