SSSSSSSSSSSSSSSS
S..............S
S........P.....S
S..............S
O..S..P..P..S...
SSSSSSSSSSSSSSSS