SSSSSSSSSSSSSSSSSSSS
S.O................S
S.PPPPP............S
S...P..............S
S...P..............S
S.....P..P.........S
S.....PPPP.........S
S.....P..P.........S
S..........PP.PP...S
S............P.....S
S..........PP.PP...S
SSSSSSSSSSSSSSSSSSSS