SSSSSSSSSSSSSSSS
S..............S
S..PSP.........S
S..PSP.........S
O..PSP..........
SSSSSSSSSSSSSSSS