SSSSSSSSSSSSSSSSSSSS
S..................L
S.....SSSSSSSSSSSSSS
S...................
S...................
S...................
S...................
S...................
SO..................
S..P................
S.PPP...............
SPPPPPPPPPPPPPSSSSSS