SSSSSSSSSSSSSSSS
S..............S
S..SSP.........S
S..SSP.........S
O..SSP..........
SSSSSSSSSSSSSSSS