SSSSSSSSSSSSSSSS
S.....P........S
S.....P..P.....S
S..............S
O..S..P..P..S...
SSSSSSSPSSSSSSSS